5,5
8
0,0,BEND,0
1,3,GOAL,0
0,1,BEND,1
0,2,BEND,2
0,3,BEND,3
1,1,BEND,0
2,2,BEND,0
3,3,BEND,0
50
50
50
50
20
20
20
20
0,1
0,2
0,3
0,4
